WE textures/wood_strips.xpm
SO textures/wood_box.xpm
EA textures/wood.xpm
NO textures/rocks.xpm

F 161,158,158
C 196,246,252

11111111111111111111111111111
1E000000000000000000000000001
10000000000000000000000000001
10000000000000000000000000001
10000000000000000000000000001
10000000000000000000000000001
10000000000000000000000000001
10000000000000000000000000001
10000000000000000000000000001
10000000000000000000000000001
10000000000000000000000000001
10000000000000000000000000001
10000000000000000000000000001
10000000000000000000000000001
10000000000000000000000000001
11111111111111111111111111111