WE textures/wood_strips.xpm
SO textures/wood_box.xpm
EA textures/wood.xpm
NO textures/rocks.xpm

F 161,158,158
C 196,246,252

1111111111111111111111111
10000000000110000000000001
1011000001110000000000001
10010000000W00000000000011111111
111111111011000001110000000000001
100000000011000001110111111111111
1111011111111101110000000001
11110111111111011101010010001
11000000110101011100000010001
10000000001 10001100000010001
10000000000100001101010010001
110000011101010111110111100111
11110111 1110101 101111010001
11111111 1111111 111111111111