WE textures/wood_strips.xpm
SO textures/wood_box.xpm
EA textures/rakhsas-_1_.xpm
NO textures/rocks.xpm

F 255,255,153
C 196,246,252

1111111111111111111111111111111111111111111111111111111111111111111111111111111111
   11111111111111000000000000001111111111111111110000011
    110000000000000000000000000000000000000000000000000011       11111111111111111
    110000000000000000000000000000000000000000000000000011       10000000000000001
    110000000000000000000000000000000000000000000000000011111111110000000000000001
    110000000000000000000000000000000000000000000000000000000000000000000000000001
    110000000000000000000000000000000000000000000000000000000000000000000000000001
    110000000000000000000000000000000000000000000000000011111111110000000000000001
    110000000000000000000000000000S00000000000000000000011       1000000000000000111111111
    110000000000000000000000000000000000000000000000000011       1000000000000000000000001
    110000000000000000000000000000000000000000000000000011   11111000000000000000000000001
    110000000000000000000000000000000000000000000000000011   10000000000000000000000000001
    110000000000000000000000000000000000000000000000000011   10000000000000000000000000001
    110000000000000000000000000000000000000000000000000011   11111111111111111111111111111
11111111111111111111111111111111111111111111111111111111111111111111111111111111111